..........
..........
....jjj...
..jjj|jjj.
----------