....|.....
....|.....
....|..h..
....|.....
----------