..........
..........
..........
....||....
----------