..........
..........
.....|....
....||....
----------