....|.....
....|.....
....|..h..
..........
----------