..........
..........
..........
|...|...|.
----------